{
    "size": [14, 13],
    "matrix": [
        [2, 2, 2, 2, 2, 2, 2, 2, 2, 2, 2, 2, 2, 2],
        [2, 2, 2, 2, 2, 2, 2, 2, 2, 2, 2, 2, 2, 2],
        [2, 2, 2, 2, 2, 2, 2, 2, 2, 0, 2, 2, 2, 2],
        [2, 2, 2, 2, 2, 2, 2, 2, 2, 0, 2, 2, 2, 2],
        [2, 2, 2, 2, 2, 0, 2, 2, 2, 0, 2, 2, 2, 2],
        [2, 1, 1, 1, 1, 0, 1, 1, 1, 0, 1, 1, 1, 2],
        [2, 1, 0, 0, 0, 0, 0, 0, 0, 0, 0, 0, 1, 2],
        [2, 1, 1, 1, 1, 1, 1, 0, 1, 1, 1, 0, 1, 2],
        [2, 2, 2, 2, 2, 2, 2, 0, 2, 2, 2, 0, 2, 2],
        [2, 2, 2, 2, 2, 2, 2, 0, 2, 2, 2, 0, 2, 2],
        [2, 2, 2, 2, 2, 2, 2, 2, 2, 2, 2, 0, 2, 2],
        [2, 2, 2, 2, 2, 2, 2, 2, 2, 2, 2, 0, 2, 2],
        [2, 2, 2, 2, 2, 2, 2, 2, 2, 2, 2, 2, 2, 2]
    ],
    "entities": {
        "tile": [
            { "type": "CrateDel", "x": 2, "y": 6 }
        ],
        "ground": [
            { "type": "Red", "x": 3, "y": 6, "direction": "W" },
            { "type": "Crate", "x": 5, "y": 4, "small": false },
            { "type": "Crate", "x": 7, "y": 9, "small": false },
            { "type": "Crate", "x": 9, "y": 2, "small": false },
            { "type": "Crate", "x": 11, "y": 11, "small": false }
        ],
        "air": [
            
        ]
    }
}