{
    "size": [13, 11],
    "matrix": [
        [2, 2, 2, 2, 2, 2, 2, 2, 2, 2, 2, 2, 2],
        [2, 2, 2, 2, 2, 2, 0, 2, 2, 2, 0, 2, 2],
        [2, 2, 2, 2, 2, 2, 0, 2, 2, 2, 0, 2, 2],
        [2, 2, 2, 2, 2, 2, 0, 2, 2, 2, 0, 2, 2],
        [2, 1, 1, 0, 0, 0, 0, 1, 1, 1, 0, 1, 2],
        [2, 1, 0, 0, 0, 0, 0, 0, 0, 0, 0, 1, 2],
        [2, 1, 1, 0, 0, 0, 0, 0, 0, 0, 0, 1, 2],
        [2, 2, 2, 2, 2, 2, 2, 2, 0, 2, 2, 2, 2],
        [2, 2, 2, 2, 2, 2, 2, 2, 0, 2, 2, 2, 2],
        [2, 2, 2, 2, 2, 2, 2, 2, 0, 2, 2, 2, 2],
        [2, 2, 2, 2, 2, 2, 2, 2, 2, 2, 2, 2, 2]
    ],
    "entities": {
        "tile": [
            { "type": "CrateDel", "x": 2, "y": 5 }
        ],
        "ground": [
            { "type": "Red", "x": 4, "y": 5, "direction": "E" },
            { "type": "Crate", "x": 6, "y": 1, "small": false },
            { "type": "Crate", "x": 10, "y": 1, "small": false },
            { "type": "Crate", "x": 8, "y": 9, "small": false }
        ],
        "air": [
            
        ]
    }
}