{
    "size": [15, 11],
    "matrix": [
        [2, 2, 2, 2, 2, 2, 2, 2, 2, 2, 2, 2, 2, 2, 2],
        [2, 1, 1, 1, 1, 1, 2, 2, 2, 2, 2, 0, 0, 0, 2],
        [2, 1, 0, 0, 0, 1, 2, 2, 2, 2, 2, 0, 1, 1, 2],
        [2, 1, 0, 0, 0, 1, 2, 2, 2, 2, 2, 0, 1, 1, 2],
        [2, 2, 2, 0, 2, 2, 2, 2, 2, 2, 2, 0, 1, 1, 2],
        [2, 2, 2, 0, 2, 2, 2, 2, 2, 2, 2, 0, 1, 1, 2],
        [2, 2, 2, 0, 2, 2, 2, 2, 2, 2, 2, 0, 1, 1, 2],
        [2, 1, 0, 0, 1, 1, 1, 0, 0, 0, 0, 0, 1, 1, 2],
        [2, 1, 0, 0, 0, 0, 0, 0, 0, 1, 0, 1, 1, 1, 2],
        [2, 1, 0, 0, 1, 1, 1, 1, 1, 1, 1, 1, 0, 0, 2],
        [2, 2, 2, 2, 2, 2, 2, 2, 2, 2, 2, 2, 2, 2, 2]
    ],
    "entities": {
        "tile": [
            { "type": "ChargePad", "x": 11, "y": 1 },
            { "type": "ChargePad", "x": 13, "y": 1 }
        ],
        "ground": [
            { "type": "Red", "x": 2, "y": 2, "direction": "S" },
            { "type": "Blue", "x": 4, "y": 2, "direction": "S" }
        ],
        "air": [

        ]
    }
}