{
    "size": [21, 21],
    "matrix": [
        [2, 2, 2, 2, 2, 2, 2, 2, 2, 2, 2, 2, 2, 2, 2, 2, 2, 2, 2, 2, 2],
        [2, 2, 2, 2, 2, 2, 2, 2, 1, 1, 1, 1, 1, 2, 2, 2, 2, 2, 2, 2, 2],
        [2, 2, 2, 2, 2, 2, 2, 2, 1, 0, 0, 0, 1, 2, 2, 2, 2, 2, 2, 2, 2],
        [2, 2, 2, 2, 2, 2, 2, 2, 1, 0, 0, 0, 1, 2, 2, 2, 2, 2, 2, 2, 2],
        [2, 2, 2, 2, 2, 2, 2, 2, 1, 0, 0, 0, 1, 2, 2, 2, 2, 2, 2, 2, 2],
        [2, 2, 2, 2, 2, 2, 2, 0, 0, 0, 0, 0, 0, 0, 2, 2, 2, 2, 2, 2, 2],
        [2, 2, 2, 2, 2, 2, 2, 1, 1, 1, 0, 0, 0, 0, 2, 2, 2, 2, 2, 2, 2],
        [2, 2, 2, 2, 2, 0, 0, 1, 1, 1, 0, 1, 1, 0, 0, 0, 2, 2, 2, 2, 2],
        [2, 1, 1, 1, 1, 0, 0, 1, 1, 1, 1, 0, 0, 0, 0, 0, 1, 1, 1, 1, 2],
        [2, 1, 0, 0, 0, 0, 0, 1, 1, 1, 1, 0, 0, 1, 0, 0, 0, 0, 0, 1, 2],
        [2, 1, 0, 0, 0, 0, 0, 1, 1, 1, 1, 0, 1, 1, 0, 0, 0, 0, 0, 1, 2],
        [2, 1, 0, 0, 0, 0, 0, 0, 0, 1, 1, 0, 1, 1, 0, 0, 0, 0, 0, 1, 2],
        [2, 1, 1, 1, 1, 0, 0, 1, 1, 1, 1, 0, 1, 0, 0, 0, 1, 1, 1, 1, 2],
        [2, 2, 2, 2, 2, 0, 0, 0, 1, 1, 1, 0, 1, 1, 1, 0, 2, 2, 2, 2, 2],
        [2, 2, 2, 2, 2, 2, 2, 0, 1, 0, 0, 0, 0, 0, 2, 2, 2, 2, 2, 2, 2],
        [2, 2, 2, 2, 2, 2, 2, 0, 0, 0, 0, 0, 0, 0, 2, 2, 2, 2, 2, 2, 2],
        [2, 2, 2, 2, 2, 2, 2, 2, 1, 0, 0, 0, 1, 2, 2, 2, 2, 2, 2, 2, 2],
        [2, 2, 2, 2, 2, 2, 2, 2, 1, 0, 0, 0, 1, 2, 2, 2, 2, 2, 2, 2, 2],
        [2, 2, 2, 2, 2, 2, 2, 2, 1, 0, 0, 0, 1, 2, 2, 2, 2, 2, 2, 2, 2],
        [2, 2, 2, 2, 2, 2, 2, 2, 1, 1, 1, 1, 1, 2, 2, 2, 2, 2, 2, 2, 2],
        [2, 2, 2, 2, 2, 2, 2, 2, 2, 2, 2, 2, 2, 2, 2, 2, 2, 2, 2, 2, 2]
    ],
    "entities": {
        "tile": [
            { "type": "CrateGen", "x": 9, "y": 2, "crate_count": 2, "crate_type": "small" },
            { "type": "CrateGen", "x": 11, "y": 2, "crate_count": 2, "crate_type": "big"},
            { "type": "CrateDel", "x": 9, "y": 18 },
            { "type": "Trap", "x": 13, "y": 7 },
            { "type": "Trap", "x": 11, "y": 11 },
            { "type": "Trap", "x": 7, "y": 14 },
            { "type": "ChargePad", "x": 9, "y": 14 },
            { "type": "ChargePad", "x": 11, "y": 14 }
        ],
        "ground": [
            { "type": "Red", "x": 11, "y": 15, "direction": "N" },
            { "type": "Blue", "x": 9, "y": 15, "direction": "N" },
            { "type": "InputTer", "x": 11, "y": 18, "ter_one": "#FF0000", "ter_two": "#00FF00", "operation": "/"},
            { "type": "OutputTer", "x": 2, "y": 10, "color": "#FF0000"},
            { "type": "OutputTer", "x": 18, "y": 10, "color": "#00FF00"},
            { "type": "Collectable", "x": 10, "y": 7 },
            { "type": "Collectable", "x": 8, "y": 11 },
            { "type": "Collectable", "x": 13, "y": 12 }
        ],
        "air": [
            { "type": "Green", "x": 10, "y": 15, "direction": "N" },
            { "type": "Collectable", "x": 8, "y": 7 }
        ]
    }
}