{
    "size": [31, 31],
    "matrix": [
        [2, 2, 2, 2, 2, 2, 2, 2, 2, 2, 2, 2, 2, 2, 2, 2, 2, 2, 2, 2, 2, 2, 2, 2, 2, 2, 2, 2, 2, 2, 2],
        [2, 2, 2, 2, 2, 2, 2, 2, 1, 1, 1, 2, 2, 2, 2, 2, 2, 2, 2, 2, 1, 1, 1, 2, 2, 2, 2, 2, 2, 2, 2],
        [2, 2, 2, 2, 2, 2, 2, 2, 1, 1, 1, 2, 2, 2, 2, 2, 2, 2, 2, 2, 1, 1, 1, 2, 2, 2, 2, 2, 2, 2, 2],
        [2, 2, 2, 0, 0, 1, 2, 2, 1, 1, 1, 2, 2, 2, 2, 2, 2, 2, 2, 2, 1, 1, 1, 2, 2, 1, 0, 0, 2, 2, 2],
        [2, 2, 2, 0, 0, 0, 0, 1, 1, 1, 1, 2, 2, 2, 2, 2, 2, 2, 2, 2, 1, 1, 1, 1, 0, 0, 0, 0, 2, 2, 2],
        [2, 2, 2, 1, 0, 0, 1, 1, 1, 1, 1, 1, 2, 2, 2, 2, 2, 2, 2, 1, 1, 1, 1, 1, 1, 0, 0, 1, 2, 2, 2],
        [2, 2, 2, 2, 0, 1, 1, 0, 0, 0, 1, 1, 1, 1, 1, 1, 1, 1, 1, 1, 1, 1, 0, 0, 0, 1, 0, 2, 2, 2, 2],
        [2, 2, 2, 2, 1, 1, 0, 2, 2, 2, 0, 1, 1, 1, 1, 1, 1, 1, 1, 1, 0, 2, 2, 2, 0, 1, 1, 2, 2, 2, 2],
        [2, 1, 1, 1, 1, 1, 0, 2, 2, 2, 0, 1, 1, 1, 1, 1, 1, 1, 1, 1, 0, 2, 2, 2, 0, 1, 1, 1, 1, 1, 2],
        [2, 1, 1, 1, 1, 1, 0, 2, 2, 2, 0, 1, 1, 1, 1, 1, 1, 1, 1, 1, 0, 2, 2, 2, 0, 1, 1, 1, 1, 1, 2],
        [2, 1, 1, 1, 1, 1, 1, 0, 0, 0, 1, 1, 1, 1, 0, 0, 0, 1, 1, 1, 1, 0, 0, 0, 1, 1, 1, 1, 1, 1, 2],
        [2, 2, 2, 2, 2, 1, 1, 1, 1, 1, 1, 1, 2, 2, 2, 0, 2, 2, 2, 1, 1, 1, 1, 1, 1, 1, 2, 2, 2, 2, 2],
        [2, 1, 1, 1, 2, 2, 1, 1, 1, 1, 1, 2, 2, 2, 2, 0, 2, 2, 2, 2, 1, 1, 1, 1, 1, 2, 2, 1, 1, 1, 2],
        [2, 0, 0, 0, 1, 2, 1, 1, 1, 1, 1, 2, 2, 2, 1, 0, 0, 2, 2, 2, 1, 1, 1, 1, 1, 2, 1, 0, 0, 0, 2],
        [2, 0, 0, 0, 1, 2, 0, 1, 1, 1, 0, 2, 2, 0, 0, 0, 0, 0, 2, 2, 0, 1, 1, 1, 0, 2, 1, 0, 0, 0, 2],
        [2, 0, 0, 0, 0, 0, 0, 1, 1, 1, 0, 0, 0, 0, 0, 0, 0, 0, 0, 0, 0, 1, 1, 1, 0, 0, 0, 0, 0, 0, 2],
        [2, 0, 0, 0, 1, 2, 0, 1, 1, 1, 0, 2, 2, 0, 0, 0, 0, 1, 2, 2, 0, 1, 1, 1, 0, 2, 1, 0, 0, 0, 2],
        [2, 0, 0, 0, 1, 2, 1, 1, 1, 1, 1, 2, 2, 2, 1, 0, 0, 2, 2, 2, 1, 1, 1, 1, 1, 2, 1, 0, 0, 0, 2],
        [2, 1, 1, 1, 2, 2, 1, 1, 1, 1, 1, 2, 2, 2, 2, 0, 2, 2, 2, 2, 1, 1, 1, 1, 1, 2, 2, 1, 1, 1, 2],
        [2, 2, 2, 2, 2, 1, 1, 1, 1, 1, 1, 1, 2, 2, 2, 0, 2, 2, 2, 1, 1, 1, 1, 1, 1, 1, 2, 2, 2, 2, 2],
        [2, 1, 1, 1, 1, 1, 1, 0, 0, 0, 1, 1, 1, 1, 0, 0, 0, 1, 1, 1, 1, 0, 0, 0, 1, 1, 1, 1, 1, 1, 2],
        [2, 1, 1, 1, 1, 1, 0, 2, 2, 2, 0, 1, 1, 1, 1, 1, 1, 1, 1, 1, 0, 2, 2, 2, 0, 1, 1, 1, 1, 1, 2],
        [2, 1, 1, 1, 1, 1, 0, 2, 2, 2, 0, 1, 1, 1, 1, 1, 1, 1, 1, 1, 0, 2, 2, 2, 0, 1, 1, 1, 1, 1, 2],
        [2, 2, 2, 2, 1, 1, 0, 2, 2, 2, 0, 1, 1, 1, 1, 1, 1, 1, 1, 1, 0, 2, 2, 2, 0, 1, 1, 2, 2, 2, 2],
        [2, 2, 2, 2, 0, 1, 1, 0, 0, 0, 1, 1, 1, 1, 1, 1, 1, 1, 1, 1, 1, 1, 0, 0, 0, 1, 0, 2, 2, 2, 2],
        [2, 2, 2, 1, 0, 0, 1, 1, 1, 1, 1, 1, 2, 2, 2, 2, 2, 2, 2, 1, 1, 1, 1, 1, 1, 0, 0, 1, 2, 2, 2],
        [2, 2, 2, 0, 0, 0, 0, 1, 1, 1, 1, 2, 2, 2, 2, 2, 2, 2, 2, 2, 1, 1, 1, 1, 0, 0, 0, 0, 2, 2, 2],
        [2, 2, 2, 0, 0, 1, 2, 2, 1, 1, 1, 2, 2, 2, 2, 2, 2, 2, 2, 2, 1, 1, 1, 2, 2, 1, 0, 0, 2, 2, 2],
        [2, 2, 2, 2, 2, 2, 2, 2, 1, 1, 1, 2, 2, 2, 2, 2, 2, 2, 2, 2, 1, 1, 1, 2, 2, 2, 2, 2, 2, 2, 2],
        [2, 2, 2, 2, 2, 2, 2, 2, 1, 1, 1, 2, 2, 2, 2, 2, 2, 2, 2, 2, 1, 1, 1, 2, 2, 2, 2, 2, 2, 2, 2],
        [2, 2, 2, 2, 2, 2, 2, 2, 2, 2, 2, 2, 2, 2, 2, 2, 2, 2, 2, 2, 2, 2, 2, 2, 2, 2, 2, 2, 2, 2, 2]
    ],
    "entities": {
        "tile": [
            { "type": "CrateDel", "x": 15, "y": 15 }
        ],
        "ground": [
            { "type": "Crate", "x": 4, "y": 4, "small": true },
            { "type": "Crate", "x": 2, "y": 15, "small": true },
            { "type": "Crate", "x": 4, "y": 26, "small": true },
            { "type": "Crate", "x": 26, "y": 4, "small": true },
            { "type": "Crate", "x": 28, "y": 15, "small": true },
            { "type": "Crate", "x": 26, "y": 26, "small": true }
        ],
        "air": [
            { "type": "Green", "x": 15, "y": 15, "direction": "S" },
            { "type": "Collectable", "x": 3, "y": 9 },
            { "type": "Collectable", "x": 3, "y": 21 },
            { "type": "Collectable", "x": 27, "y": 9 },
            { "type": "Collectable", "x": 27, "y": 21 }
        ]
    }
}