{
    "size": [15, 11],
    "matrix": [
        [2, 2, 2, 2, 2, 2, 2, 2, 2, 2, 2, 2, 2, 2, 2],
        [2, 2, 2, 2, 2, 2, 1, 1, 1, 2, 2, 2, 2, 2, 2],
        [2, 2, 2, 0, 0, 0, 0, 0, 0, 0, 0, 0, 2, 2, 2],
        [2, 2, 2, 0, 0, 0, 0, 0, 0, 0, 0, 0, 2, 2, 2],
        [2, 1, 0, 0, 1, 2, 2, 2, 2, 2, 1, 0, 0, 1, 2],
        [2, 1, 0, 0, 1, 2, 2, 2, 2, 2, 1, 0, 0, 1, 2],
        [2, 1, 0, 0, 1, 2, 2, 2, 2, 2, 1, 0, 0, 1, 2],
        [2, 2, 2, 0, 0, 0, 0, 0, 0, 0, 0, 0, 2, 2, 2],
        [2, 2, 2, 0, 0, 0, 0, 0, 0, 0, 0, 0, 2, 2, 2],
        [2, 2, 2, 2, 2, 2, 1, 1, 1, 2, 2, 2, 2, 2, 2],
        [2, 2, 2, 2, 2, 2, 2, 2, 2, 2, 2, 2, 2, 2, 2]
    ],
    "entities": {
        "tile": [
            { "type": "CrateGen", "x": 7, "y": 8, "crate_count": 4, "crate_type": "small" },
            { "type": "CrateDel", "x": 7, "y": 2 }
        ],
        "ground": [
            { "type": "Red", "x": 2, "y": 5, "direction": "E" }
        ],
        "air": [
            { "type": "Green", "x": 12, "y": 5, "direction": "W" }
        ]
    }
}