{
    "size": [28, 31],
    "matrix": [
        [2, 2, 2, 2, 2, 2, 2, 2, 2, 2, 2, 2, 2, 2, 2, 2, 2, 2, 2, 2, 2, 2, 2, 2, 2, 2, 2, 2],
        [2, 0, 0, 0, 0, 0, 0, 2, 2, 0, 0, 0, 0, 0, 0, 0, 0, 0, 0, 2, 2, 0, 0, 0, 0, 0, 0, 2],
        [2, 0, 2, 2, 2, 2, 0, 2, 2, 0, 2, 2, 2, 2, 2, 2, 2, 2, 0, 2, 2, 0, 2, 2, 2, 2, 0, 2],
        [2, 0, 2, 2, 2, 2, 0, 2, 2, 0, 2, 2, 2, 2, 2, 2, 2, 2, 0, 2, 2, 0, 2, 2, 2, 2, 0, 2],
        [2, 0, 2, 2, 0, 0, 0, 2, 2, 0, 2, 2, 2, 2, 2, 2, 2, 2, 0, 2, 2, 0, 0, 0, 2, 2, 0, 2],
        [2, 0, 2, 2, 0, 2, 2, 2, 2, 0, 2, 2, 0, 0, 0, 0, 2, 2, 0, 2, 2, 2, 2, 0, 2, 2, 0, 2],
        [2, 0, 2, 2, 0, 2, 2, 2, 2, 0, 2, 2, 0, 2, 2, 0, 2, 2, 0, 2, 2, 2, 2, 0, 2, 2, 0, 2],
        [2, 0, 2, 2, 0, 0, 0, 2, 2, 0, 2, 2, 0, 2, 2, 0, 2, 2, 0, 2, 2, 0, 0, 0, 2, 2, 0, 2],
        [2, 0, 2, 2, 2, 2, 0, 2, 2, 0, 0, 0, 0, 2, 2, 0, 0, 0, 0, 2, 2, 0, 2, 2, 2, 2, 0, 2],
        [2, 0, 2, 2, 2, 2, 0, 2, 2, 0, 2, 2, 2, 2, 2, 2, 2, 2, 0, 2, 2, 0, 2, 2, 2, 2, 0, 2],
        [2, 0, 0, 0, 2, 2, 0, 2, 2, 0, 2, 2, 2, 2, 2, 2, 2, 2, 0, 2, 2, 0, 2, 2, 0, 0, 0, 2],
        [2, 2, 2, 0, 2, 2, 0, 0, 0, 0, 0, 0, 0, 0, 0, 0, 0, 0, 0, 0, 0, 0, 2, 2, 0, 2, 2, 2],
        [2, 2, 2, 0, 2, 2, 2, 2, 2, 0, 2, 2, 2, 0, 0, 2, 2, 2, 0, 2, 2, 2, 2, 2, 0, 2, 2, 2],
        [2, 0, 0, 0, 2, 2, 2, 2, 2, 0, 2, 0, 0, 0, 0, 0, 0, 2, 0, 2, 2, 2, 2, 2, 0, 0, 0, 2],
        [2, 2, 2, 0, 2, 2, 2, 2, 2, 0, 2, 0, 0, 0, 0, 0, 0, 2, 0, 2, 2, 2, 2, 2, 0, 2, 2, 2],
        [2, 2, 2, 0, 2, 2, 2, 2, 2, 0, 2, 0, 0, 0, 0, 0, 0, 2, 0, 2, 2, 2, 2, 2, 0, 2, 2, 2],
        [2, 2, 2, 0, 2, 2, 2, 2, 2, 0, 2, 2, 2, 2, 2, 2, 2, 2, 0, 2, 2, 2, 2, 2, 0, 2, 2, 2],
        [2, 0, 0, 0, 0, 0, 0, 2, 2, 0, 0, 0, 0, 2, 2, 0, 0, 0, 0, 2, 2, 0, 0, 0, 0, 0, 0, 2],
        [2, 0, 2, 2, 2, 2, 0, 2, 2, 2, 2, 2, 0, 2, 2, 0, 2, 2, 2, 2, 2, 0, 2, 2, 2, 2, 0, 2],
        [2, 0, 2, 2, 2, 2, 0, 2, 2, 2, 2, 2, 0, 2, 2, 0, 2, 2, 2, 2, 2, 0, 2, 2, 2, 2, 0, 2],
        [2, 0, 0, 0, 2, 2, 0, 0, 0, 0, 0, 0, 0, 2, 2, 0, 0, 0, 0, 0, 0, 0, 2, 2, 0, 0, 0, 2],
        [2, 2, 2, 0, 2, 2, 0, 2, 2, 2, 2, 2, 2, 2, 2, 2, 2, 2, 2, 2, 2, 0, 2, 2, 0, 2, 2, 2],
        [2, 2, 2, 0, 2, 2, 0, 2, 2, 2, 2, 2, 2, 2, 2, 2, 2, 2, 2, 2, 2, 0, 2, 2, 0, 2, 2, 2],
        [2, 2, 2, 0, 2, 2, 0, 2, 2, 0, 0, 0, 0, 0, 0, 0, 0, 0, 0, 2, 2, 0, 2, 2, 0, 2, 2, 2],
        [2, 2, 2, 0, 2, 2, 0, 2, 2, 2, 2, 2, 0, 2, 2, 0, 2, 2, 2, 2, 2, 0, 2, 2, 0, 2, 2, 2],
        [2, 2, 2, 0, 2, 2, 0, 2, 2, 2, 2, 2, 0, 2, 2, 0, 2, 2, 2, 2, 2, 0, 2, 2, 0, 2, 2, 2],
        [2, 0, 0, 0, 2, 2, 0, 0, 0, 0, 0, 0, 0, 2, 2, 0, 0, 0, 0, 0, 0, 0, 2, 2, 0, 0, 0, 2],
        [2, 0, 2, 2, 2, 2, 0, 2, 2, 0, 2, 2, 2, 2, 2, 2, 2, 2, 0, 2, 2, 0, 2, 2, 2, 2, 0, 2],
        [2, 0, 2, 2, 2, 2, 0, 2, 2, 0, 2, 2, 2, 2, 2, 2, 2, 2, 0, 2, 2, 0, 2, 2, 2, 2, 0, 2],
        [2, 0, 0, 0, 0, 0, 0, 2, 2, 0, 0, 0, 0, 0, 0, 0, 0, 0, 0, 2, 2, 0, 0, 0, 0, 0, 0, 2],
        [2, 2, 2, 2, 2, 2, 2, 2, 2, 2, 2, 2, 2, 2, 2, 2, 2, 2, 2, 2, 2, 2, 2, 2, 2, 2, 2, 2]
    ],
    "entities": {
        "tile": [
            { "type": "ChargePad", "x": 1, "y": 13 },
            { "type": "ChargePad", "x": 26, "y": 13 },
            { "type": "Trap", "x": 12, "y": 7 },
            { "type": "Trap", "x": 15, "y": 7 },
            { "type": "Trap", "x": 6, "y": 8 },
            { "type": "Trap", "x": 21, "y": 8 },
            { "type": "Trap", "x": 3, "y": 12 },
            { "type": "Trap", "x": 24, "y": 12 },
            { "type": "Trap", "x": 5, "y": 17 },
            { "type": "Trap", "x": 22, "y": 17 },
            { "type": "Trap", "x": 3, "y": 23 },
            { "type": "Trap", "x": 6, "y": 23 },
            { "type": "Trap", "x": 21, "y": 23 },
            { "type": "Trap", "x": 24, "y": 23 },
            { "type": "Trap", "x": 12, "y": 24 },
            { "type": "Trap", "x": 15, "y": 24 },
            { "type": "Trap", "x": 6, "y": 18 },
            { "type": "Trap", "x": 21, "y": 18 }
        ],
        "ground": [
            { "type": "Red", "x": 12, "y": 14, "direction": "E" },
            { "type": "Blue", "x": 15, "y": 14, "direction": "W" },
            { "type": "Collectable", "x": 3, "y": 24 },
            { "type": "Collectable", "x": 6, "y": 24 },
            { "type": "Collectable", "x": 21, "y": 24 },
            { "type": "Collectable", "x": 24, "y": 24 }
        ],
        "air": [

        ]
    }
}