{
    "size": [13, 11],
    "matrix": [
        [2, 2, 2, 2, 2, 2, 2, 2, 2, 2, 2, 2, 2],
        [2, 0, 0, 0, 0, 0, 0, 0, 2, 2, 2, 2, 2],
        [2, 0, 0, 0, 0, 0, 0, 0, 2, 2, 2, 2, 2],
        [2, 0, 0, 0, 0, 0, 0, 0, 2, 2, 2, 2, 2],
        [2, 2, 2, 2, 2, 0, 0, 0, 2, 2, 2, 2, 2],
        [2, 2, 2, 2, 2, 0, 0, 0, 2, 2, 2, 2, 2],
        [2, 2, 2, 2, 2, 0, 0, 0, 2, 2, 2, 2, 2],
        [2, 2, 2, 2, 2, 0, 0, 0, 1, 0, 0, 0, 2],
        [2, 2, 2, 2, 2, 0, 0, 0, 1, 0, 0, 0, 2],
        [2, 2, 2, 2, 2, 0, 0, 0, 1, 0, 0, 0, 2],
        [2, 2, 2, 2, 2, 2, 2, 2, 2, 2, 2, 2, 2]
    ],
    "entities": {
        "tile": [
            { "type": "CrateDel", "x": 6, "y": 5 }
        ],
        "ground": [
            { "type": "Red", "x": 6, "y": 8, "direction": "N" },
            { "type": "Crate", "x": 10, "y": 8, "small": true },
            { "type": "Crate", "x": 2, "y": 2, "small": false }
        ],
        "air": [
            { "type": "Green", "x": 6, "y": 2, "direction": "S" }
        ]
    }
}