{
    "size": [14, 11],
    "matrix": [
        [2, 2, 2, 2, 2, 2, 2, 2, 2, 2, 2, 2, 2, 2],
        [2, 0, 0, 0, 0, 1, 2, 2, 1, 0, 0, 0, 1, 2],
        [2, 0, 0, 0, 0, 1, 2, 2, 1, 0, 0, 0, 1, 2],
        [2, 0, 0, 0, 0, 1, 2, 2, 1, 0, 0, 0, 1, 2],
        [2, 1, 1, 1, 0, 1, 2, 2, 1, 0, 0, 0, 1, 2],
        [2, 1, 1, 1, 0, 1, 2, 2, 1, 0, 0, 0, 1, 2],
        [2, 0, 0, 0, 0, 1, 2, 2, 2, 2, 0, 2, 2, 2],
        [2, 0, 0, 0, 0, 0, 0, 0, 0, 0, 0, 0, 1, 2],
        [2, 0, 0, 0, 0, 0, 0, 0, 0, 0, 0, 0, 1, 2],
        [2, 1, 1, 0, 0, 1, 1, 2, 2, 2, 2, 2, 2, 2],
        [2, 2, 2, 2, 2, 2, 2, 2, 2, 2, 2, 2, 2, 2]
    ],
    "entities": {
        "tile": [
            { "type": "CrateDel", "x": 2, "y": 8 }
        ],
        "ground": [
            { "type": "Red", "x": 2, "y": 2, "direction": "E" },
            { "type": "Crate", "x": 10, "y": 3, "small": false },
            { "type": "Collectable", "x": 2, "y": 6 }
        ],
        "air": [

        ]
    }
}