{
    "size": [10, 15],
    "matrix": [
        [2, 2, 2, 2, 2, 2, 2, 2, 2, 2],
        [2, 2, 2, 2, 2, 0, 0, 0, 0, 2],
        [2, 2, 2, 2, 2, 0, 0, 0, 0, 2],
        [2, 2, 2, 2, 2, 1, 1, 0, 0, 2],
        [2, 2, 2, 2, 2, 0, 0, 0, 0, 2],
        [2, 1, 1, 1, 1, 0, 0, 0, 0, 2],
        [2, 0, 0, 0, 0, 0, 1, 1, 0, 2],
        [2, 0, 0, 0, 1, 0, 1, 1, 0, 2],
        [2, 1, 1, 1, 1, 0, 1, 1, 0, 2],
        [2, 0, 0, 1, 0, 0, 0, 0, 0, 2],
        [2, 0, 0, 0, 0, 2, 2, 2, 2, 2],
        [2, 0, 0, 0, 0, 2, 2, 2, 2, 2],
        [2, 0, 0, 0, 1, 2, 2, 2, 2, 2],
        [2, 0, 0, 0, 1, 2, 2, 2, 2, 2],
        [2, 2, 2, 2, 2, 2, 2, 2, 2, 2]
    ],
    "entities": {
        "tile": [
            { "type": "ChargePad", "x": 7, "y": 2 }
        ],
        "ground": [
            { "type": "Red", "x": 2, "y": 12, "direction": "N" },
            { "type": "Collectable", "x": 2, "y": 6 }
        ], 
        "air": [

        ]
    }
}